                                                                                
          ------------                                                          
          |..........+#######------                      -----------------      
          |..........|      #+....+##############        |...............|      
          |..........|       |....|             #        |...............|      
          |.......%..|       |....|             #########+...............|      
          --+---------       ------                      --------+--------      
            ####                                                 ######         
      ---------+---                                                ---+-        
      |...........|         --------------                         |...|        
      |...........|         |............|                    #####+...|        
      |...........|         |............|                    #    |...|        
      |...........+######## |............+#####################    |...|        
      |...........|       ##+............|                         |...|        
      ---------+---         --------+-----                         ---+-        
               #                    ##                                #         
        ########                   --+---                         #####         
  ------+-----------               |....|                         #             
  |................|               |....|                                       
  |................|               ------                                       
  |................|                                                            
  |................|                                                            
  ------------------                                                            