                                                                                
     --------------                                                             
     |..%.........|                   ######                                    
     |............|                   #    ###############################      
     |............|                   #######                            #      
     ---------+----                         #               ##############      
              #                             #               #                   
       -------+------                       #               #                   
       |............+########################               #                   
       |............|                      ##               #                   
       |............|                       #               #                   
       |............|                       #               #                   
       |............|                       #               #                   
       --------+-----                       #               #                   
     ###########                    #########               #                   
   --+--------------            ----+---------              ########            
   |...............|            |............|                     #            
   |...............|            |............|                     #            
   |...............|            |............|            ---------+--------    
   |...............+############+............+#######     |................|    
   -----------------            |............|      ######+................|    
                                --------------            ------------------    
                                                                                